5,5,5,5,5,5,5,5,5,5,5,5,5,5,5,5,5,5,5,5,5,5,5
5,5,5,5,5,5,5,5,5,5,5,5,5,5,5,5,5,5,5,5,5,5,5
5,5,5,5,5,5,5,5,5,5,5,5,5,5,5,5,5,5,5,5,5,5,5
5,5,5,5,5,5,5,5,5,0,0,0,0,5,5,5,5,5,5,5,5,5,5
5,5,5,5,5,5,5,0,0,0,1,1,0,0,0,5,5,5,5,5,5,5,5
5,5,5,5,5,5,5,0,1,2,2,3,3,1,0,5,5,5,5,5,5,5,5
5,5,5,5,5,5,5,0,1,0,0,1,0,1,0,5,5,5,5,5,5,5,5
5,5,5,5,5,5,5,0,1,1,1,1,1,4,0,5,5,5,5,5,5,5,5
5,5,5,5,5,5,5,0,0,0,0,0,0,0,0,5,5,5,5,5,5,5,5
5,5,5,5,5,5,5,5,5,5,5,5,5,5,5,5,5,5,5,5,5,5,5
5,5,5,5,5,5,5,5,5,5,5,5,5,5,5,5,5,5,5,5,5,5,5
5,5,5,5,5,5,5,5,5,5,5,5,5,5,5,5,5,5,5,5,5,5,5
5,5,5,5,5,5,5,5,5,5,5,5,5,5,5,5,5,5,5,5,5,5,5

