5,5,5,5,5,5,5,5,5,5,5,5,5,5,5,5,5,5,5,5,5,5,5
5,5,5,5,5,5,5,5,5,5,5,5,5,5,5,5,5,5,5,5,5,5,5
5,5,5,5,5,5,5,0,0,0,0,0,5,5,5,5,5,5,5,5,5,5,5
5,5,5,5,5,5,5,0,1,1,1,0,0,0,0,5,5,5,5,5,5,5,5
5,5,5,5,5,5,5,0,1,2,1,1,1,1,0,5,5,5,5,5,5,5,5
5,5,5,5,5,5,5,0,0,2,0,0,0,3,0,0,5,5,5,5,5,5,5
5,5,5,5,5,5,5,0,1,1,1,1,1,4,1,0,5,5,5,5,5,5,5
5,5,5,5,5,5,5,0,1,3,0,0,1,1,1,0,5,5,5,5,5,5,5
5,5,5,5,5,5,5,0,1,1,0,0,0,0,0,0,5,5,5,5,5,5,5
5,5,5,5,5,5,5,0,0,0,0,5,5,5,5,5,5,5,5,5,5,5,5
5,5,5,5,5,5,5,5,5,5,5,5,5,5,5,5,5,5,5,5,5,5,5
5,5,5,5,5,5,5,5,5,5,5,5,5,5,5,5,5,5,5,5,5,5,5
5,5,5,5,5,5,5,5,5,5,5,5,5,5,5,5,5,5,5,5,5,5,5

