5,5,5,5,5,5,5,5,5,5,5,5,5,5,5,5,5,5,5,5,5,5,5
5,5,5,5,5,5,5,5,5,5,5,5,5,5,5,5,5,5,5,5,5,5,5
5,5,5,5,5,5,5,5,5,5,5,5,0,0,0,0,5,5,5,5,5,5,5
5,5,5,5,5,5,5,5,0,0,0,0,0,1,1,0,5,5,5,5,5,5,5
5,5,5,5,5,5,5,0,0,1,1,1,1,1,1,0,5,5,5,5,5,5,5
5,5,5,5,5,5,5,0,1,2,4,3,1,2,1,0,5,5,5,5,5,5,5
5,5,5,5,5,5,5,0,0,3,0,0,3,0,0,0,5,5,5,5,5,5,5
5,5,5,5,5,5,5,0,1,2,1,3,1,2,1,0,5,5,5,5,5,5,5
5,5,5,5,5,5,5,0,1,1,1,1,1,1,0,0,5,5,5,5,5,5,5
5,5,5,5,5,5,5,0,1,1,0,0,0,0,0,5,5,5,5,5,5,5,5
5,5,5,5,5,5,5,0,0,0,0,5,5,5,5,5,5,5,5,5,5,5,5
5,5,5,5,5,5,5,5,5,5,5,5,5,5,5,5,5,5,5,5,5,5,5
5,5,5,5,5,5,5,5,5,5,5,5,5,5,5,5,5,5,5,5,5,5,5

