5,5,5,5,5,5,5,5,5,5,5,5,5,5,5,5,5,5,5,5,5,5,5
5,5,5,5,5,5,5,5,5,5,5,5,5,5,5,5,5,5,5,5,5,5,5
5,5,5,5,5,5,5,5,5,5,0,0,0,0,0,0,5,5,5,5,5,5,5
5,5,5,5,5,5,5,5,5,5,0,1,1,1,1,0,5,5,5,5,5,5,5
5,5,5,5,5,5,0,0,0,0,0,1,3,1,1,0,5,5,5,5,5,5,5
5,5,5,5,5,5,0,1,2,1,1,0,3,1,1,0,5,5,5,5,5,5,5
5,5,5,5,5,5,0,1,2,1,1,0,1,1,0,0,5,5,5,5,5,5,5
5,5,5,5,5,5,0,1,2,3,1,0,1,3,0,5,5,5,5,5,5,5,5
5,5,5,5,5,5,0,1,2,1,1,3,1,1,0,5,5,5,5,5,5,5,5
5,5,5,5,5,5,0,1,2,0,0,0,4,0,0,5,5,5,5,5,5,5,5
5,5,5,5,5,5,0,0,0,0,5,0,0,0,5,5,5,5,5,5,5,5,5
5,5,5,5,5,5,5,5,5,5,5,5,5,5,5,5,5,5,5,5,5,5,5
5,5,5,5,5,5,5,5,5,5,5,5,5,5,5,5,5,5,5,5,5,5,5

