5,5,5,5,5,5,5,5,5,5,5,5,5,5,5,5,5,5,5,5,5,5,5
5,5,5,5,5,5,5,5,5,5,5,5,5,5,5,5,5,5,5,5,5,5,5
5,5,5,5,5,5,5,5,0,0,0,0,5,5,5,5,5,5,5,5,5,5,5
5,5,5,5,5,5,5,5,0,1,1,0,0,0,0,0,5,5,5,5,5,5,5
5,5,5,5,5,5,5,5,0,1,1,0,1,1,2,0,5,5,5,5,5,5,5
5,5,5,5,5,5,5,0,0,1,3,0,3,1,2,0,5,5,5,5,5,5,5
5,5,5,5,5,5,5,0,1,1,1,4,1,1,1,0,5,5,5,5,5,5,5
5,5,5,5,5,5,5,0,2,1,3,0,3,1,0,0,5,5,5,5,5,5,5
5,5,5,5,5,5,5,0,2,1,1,0,1,1,0,5,5,5,5,5,5,5,5
5,5,5,5,5,5,5,0,0,0,0,0,0,0,0,5,5,5,5,5,5,5,5
5,5,5,5,5,5,5,5,5,5,5,5,5,5,5,5,5,5,5,5,5,5,5
5,5,5,5,5,5,5,5,5,5,5,5,5,5,5,5,5,5,5,5,5,5,5
5,5,5,5,5,5,5,5,5,5,5,5,5,5,5,5,5,5,5,5,5,5,5

